{
  "row": 8,
  "screens": [
    {
      "col": 6,
      "tiles": [
        [1, 1, 1, 1, 1, 1, 1, 1, 1, 1, 1, 1, 1, 1, 1, 1],
        [1, 1, 1, 0, 0, 0, 46, 46, 46, 46, 0, 0, 0, 0, 0, 0],
        [1, 1, 0, 0, 16, 0, 0, 0, 0, 0, 0, 16, 0, 0, 0, 0],
        [1, 0, 0, 0, 0, 0, 0, 0, 0, 0, 0, 0, 0, 0, 0, 0],
        [1, 0, 0, 16, 0, 0, 41, 41, 41, 41, 0, 0, 16, 0, 0, 0],
        [1, 0, 0, 0, 0, 0, 0, 0, 0, 0, 0, 0, 0, 0, 0, 0],
        [1, 0, 16, 0, 0, 0, 0, 0, 0, 0, 0, 0, 0, 16, 0, 0],
        [1, 0, 0, 0, 0, 0, 41, 41, 41, 41, 0, 0, 0, 0, 0, 0],
        [1, 0, 0, 0, 16, 0, 0, 0, 0, 0, 0, 16, 0, 0, 0, 0],
        [1, 0, 0, 0, 0, 0, 0, 0, 0, 0, 0, 0, 0, 0, 0, 0],
        [1, 1, 0, 0, 0, 46, 46, 46, 46, 46, 46, 0, 0, 0, 0, 0],
        [1, 1, 1, 0, 0, 0, 0, 0, 0, 0, 0, 0, 0, 0, 0, 0]
      ],
      "enemies": [],
      "items": [],
      "npcs": [],
      "warps": []
    },
    {
      "col": 7,
      "tiles": [
        [1, 0, 0, 0, 0, 0, 3, 3, 0, 0, 0, 0, 0, 0, 0, 0],
        [1, 0, 0, 0, 0, 0, 0, 0, 0, 0, 4, 4, 2, 2, 2, 2],
        [1, 0, 3, 3, 0, 0, 0, 0, 0, 4, 4, 4, 2, 2, 2, 2],
        [1, 0, 0, 0, 0, 0, 0, 0, 4, 4, 2, 2, 2, 2, 2, 2],
        [1, 0, 0, 0, 3, 3, 0, 0, 4, 4, 2, 2, 2, 2, 2, 2],
        [1, 0, 0, 0, 0, 0, 0, 0, 4, 4, 2, 2, 2, 2, 2, 2],
        [1, 0, 0, 0, 0, 0, 0, 4, 4, 4, 2, 2, 2, 2, 2, 2],
        [1, 0, 0, 0, 0, 0, 0, 0, 4, 4, 2, 2, 2, 2, 2, 2],
        [1, 0, 0, 3, 3, 0, 0, 0, 4, 4, 2, 2, 2, 2, 2, 2],
        [1, 0, 0, 0, 0, 0, 0, 0, 4, 4, 4, 2, 2, 2, 2, 2],
        [1, 0, 0, 0, 0, 0, 0, 0, 0, 0, 4, 4, 2, 2, 2, 2],
        [1, 0, 0, 0, 0, 0, 4, 4, 0, 0, 0, 0, 0, 0, 0, 0]
      ],
      "enemies": [
        {"type": 0, "x": 3, "y": 3},
        {"type": 0, "x": 5, "y": 8}
      ],
      "items": [
        {"type": 4, "x": 3, "y": 6}
      ],
      "npcs": [],
      "warps": []
    },
    {
      "col": 8,
      "tiles": [
        [0, 0, 0, 0, 0, 0, 0, 0, 0, 0, 0, 0, 0, 0, 0, 0],
        [0, 44, 44, 44, 44, 0, 0, 41, 41, 0, 0, 44, 44, 44, 44, 0],
        [0, 43, 43, 43, 43, 0, 0, 0, 0, 0, 0, 1, 45, 45, 1, 0],
        [0, 1, 8, 8, 1, 0, 0, 0, 0, 0, 0, 1, 8, 8, 1, 0],
        [0, 0, 0, 0, 0, 0, 0, 23, 0, 0, 0, 0, 0, 0, 0, 0],
        [0, 0, 0, 0, 0, 0, 41, 41, 41, 41, 0, 0, 0, 0, 0, 0],
        [0, 0, 40, 0, 0, 0, 0, 0, 0, 0, 0, 0, 0, 40, 0, 0],
        [0, 0, 0, 0, 0, 0, 0, 2, 2, 0, 0, 0, 0, 0, 0, 0],
        [0, 0, 0, 0, 0, 0, 0, 2, 2, 0, 0, 0, 0, 0, 0, 0],
        [0, 0, 16, 0, 0, 0, 0, 0, 0, 0, 0, 0, 16, 0, 0, 0],
        [0, 0, 0, 0, 0, 41, 41, 41, 41, 41, 41, 0, 0, 0, 0, 0],
        [0, 0, 0, 0, 0, 0, 0, 0, 0, 0, 0, 0, 0, 0, 0, 0]
      ],
      "enemies": [],
      "items": [],
      "npcs": [
        {
          "id": "marin", "x": 6, "y": 6, "dir": 0, "name": "Marin",
          "dialogue_key": "marin_singing",
          "dialogues": [
            {"key": "marin_met", "condition": "flag:talked_marin"}
          ]
        },
        {
          "id": "kid", "x": 10, "y": 9, "dir": 2, "name": "Kid",
          "dialogue_key": "kid_village"
        }
      ],
      "warps": [
        {"x": 2, "y": 3, "target": "interior:tarins_house", "sx": 112, "sy": 144, "ex": 33, "ey": 66},
        {"x": 3, "y": 3, "target": "interior:tarins_house", "sx": 112, "sy": 144, "ex": 49, "ey": 66},
        {"x": 12, "y": 3, "target": "interior:village_shop", "sx": 112, "sy": 144, "ex": 193, "ey": 66},
        {"x": 13, "y": 3, "target": "interior:village_shop", "sx": 112, "sy": 144, "ex": 209, "ey": 66}
      ]
    },
    {
      "col": 9,
      "tiles": [
        [0, 0, 0, 0, 0, 0, 0, 0, 0, 0, 0, 0, 0, 0, 0, 1],
        [0, 44, 44, 44, 44, 0, 0, 0, 0, 0, 20, 0, 3, 3, 0, 1],
        [0, 1, 45, 45, 1, 0, 0, 0, 0, 0, 0, 0, 0, 0, 0, 1],
        [0, 1, 8, 8, 1, 0, 0, 0, 0, 0, 0, 3, 3, 0, 0, 1],
        [0, 0, 0, 0, 0, 0, 0, 0, 0, 0, 0, 0, 0, 0, 0, 1],
        [0, 0, 0, 0, 0, 0, 41, 41, 41, 41, 0, 0, 0, 0, 0, 1],
        [0, 0, 0, 40, 0, 0, 0, 0, 0, 0, 0, 0, 40, 0, 0, 1],
        [0, 0, 0, 0, 0, 0, 0, 0, 0, 0, 0, 0, 0, 0, 0, 1],
        [0, 0, 0, 0, 0, 0, 0, 0, 0, 0, 0, 0, 0, 0, 0, 1],
        [0, 0, 3, 3, 0, 0, 0, 0, 0, 0, 0, 3, 3, 0, 0, 1],
        [0, 0, 0, 0, 0, 0, 0, 0, 0, 0, 0, 0, 0, 0, 0, 1],
        [0, 0, 0, 0, 0, 0, 0, 0, 0, 0, 0, 0, 0, 0, 0, 1]
      ],
      "enemies": [
        {"type": 0, "x": 10, "y": 8}
      ],
      "items": [],
      "npcs": [
        {
          "id": "villager_east", "x": 6, "y": 7, "dir": 2, "name": "Villager",
          "dialogue_key": "villager_east"
        }
      ],
      "warps": [
        {"x": 2, "y": 3, "target": "interior:library", "sx": 112, "sy": 144, "ex": 33, "ey": 66},
        {"x": 3, "y": 3, "target": "interior:library", "sx": 112, "sy": 144, "ex": 49, "ey": 66}
      ]
    },
    {
      "col": 10,
      "tiles": [
        [0, 0, 0, 0, 0, 0, 0, 0, 0, 0, 1, 1, 1, 1, 1, 1],
        [0, 0, 3, 3, 0, 0, 0, 0, 0, 0, 0, 3, 3, 0, 0, 1],
        [0, 0, 0, 0, 0, 0, 0, 3, 3, 0, 0, 0, 0, 0, 0, 1],
        [0, 0, 0, 0, 0, 0, 0, 0, 0, 0, 0, 0, 3, 3, 0, 1],
        [0, 0, 3, 3, 0, 0, 0, 0, 0, 0, 0, 0, 0, 0, 0, 1],
        [0, 0, 0, 0, 0, 0, 3, 3, 0, 0, 3, 3, 0, 0, 0, 1],
        [0, 0, 0, 0, 0, 0, 0, 0, 0, 0, 0, 0, 0, 0, 0, 1],
        [0, 0, 3, 3, 0, 0, 0, 0, 0, 0, 0, 3, 3, 0, 0, 1],
        [0, 0, 0, 0, 0, 0, 0, 0, 0, 0, 0, 0, 0, 0, 0, 1],
        [0, 0, 0, 0, 0, 0, 3, 3, 0, 0, 0, 0, 0, 0, 1, 1],
        [0, 0, 3, 3, 0, 0, 0, 0, 0, 0, 3, 3, 0, 0, 1, 1],
        [0, 0, 0, 0, 0, 0, 0, 0, 0, 0, 0, 0, 0, 0, 1, 1]
      ],
      "enemies": [
        {"type": 0, "x": 5, "y": 3},
        {"type": 0, "x": 9, "y": 7}
      ],
      "items": [
        {"type": 1, "x": 8, "y": 5}
      ],
      "npcs": [],
      "warps": []
    }
  ]
}
