{
  "row": 11,
  "screens": [
    {
      "col": 6,
      "tiles": [
        [1, 0, 0, 4, 4, 4, 4, 4, 4, 4, 4, 4, 4, 4, 4, 4],
        [1, 0, 0, 0, 4, 4, 4, 4, 4, 4, 4, 4, 4, 4, 4, 4],
        [1, 0, 0, 0, 0, 4, 4, 4, 4, 4, 4, 4, 4, 4, 4, 4],
        [1, 0, 0, 0, 0, 0, 4, 4, 4, 4, 4, 4, 4, 4, 4, 4],
        [1, 0, 0, 0, 0, 0, 0, 4, 4, 4, 4, 4, 4, 4, 4, 4],
        [1, 2, 0, 0, 0, 0, 0, 0, 4, 4, 4, 4, 4, 4, 4, 4],
        [2, 2, 2, 0, 0, 0, 0, 0, 0, 4, 4, 4, 4, 4, 4, 4],
        [2, 2, 2, 2, 0, 0, 0, 0, 0, 0, 4, 4, 4, 4, 4, 4],
        [2, 2, 2, 2, 2, 0, 0, 0, 0, 0, 0, 4, 4, 4, 4, 4],
        [2, 2, 2, 2, 2, 2, 0, 0, 0, 0, 0, 0, 4, 4, 4, 4],
        [2, 2, 2, 2, 2, 2, 2, 0, 0, 0, 0, 0, 0, 4, 4, 4],
        [2, 2, 2, 2, 2, 2, 2, 2, 0, 0, 0, 0, 0, 0, 4, 4]
      ],
      "enemies": [],
      "items": [],
      "npcs": [],
      "warps": []
    },
    {
      "col": 7,
      "tiles": [
        [0, 0, 0, 4, 4, 4, 4, 4, 4, 4, 4, 4, 4, 0, 0, 0],
        [0, 0, 4, 4, 4, 4, 4, 4, 4, 4, 4, 4, 0, 0, 0, 0],
        [0, 4, 4, 4, 4, 4, 4, 4, 4, 4, 4, 0, 0, 0, 0, 0],
        [4, 4, 4, 4, 4, 4, 4, 4, 4, 4, 0, 0, 0, 0, 0, 0],
        [4, 4, 4, 4, 4, 4, 4, 4, 4, 0, 0, 0, 0, 0, 0, 0],
        [4, 4, 4, 4, 4, 4, 4, 4, 0, 0, 0, 0, 9, 0, 0, 0],
        [4, 4, 4, 4, 4, 4, 4, 0, 0, 0, 0, 9, 9, 0, 0, 0],
        [4, 4, 4, 4, 4, 4, 0, 0, 0, 0, 0, 0, 0, 0, 0, 0],
        [4, 4, 4, 4, 4, 0, 0, 0, 0, 0, 0, 0, 0, 0, 0, 0],
        [4, 4, 4, 4, 0, 0, 0, 0, 0, 0, 0, 0, 4, 0, 0, 0],
        [4, 4, 4, 0, 0, 0, 0, 0, 0, 4, 4, 0, 0, 0, 0, 0],
        [4, 4, 0, 0, 0, 0, 0, 4, 4, 4, 0, 0, 0, 0, 0, 0]
      ],
      "enemies": [
        {"type": 0, "x": 10, "y": 7},
        {"type": 0, "x": 13, "y": 5}
      ],
      "items": [],
      "npcs": [
        {
          "id": "hermit", "x": 8, "y": 8, "dir": 0, "name": "Hermit",
          "dialogue_key": "beach_hermit"
        }
      ],
      "warps": []
    },
    {
      "col": 8,
      "tiles": [
        [4, 4, 4, 4, 4, 4, 4, 4, 4, 4, 4, 4, 4, 4, 4, 4],
        [4, 4, 4, 4, 4, 4, 4, 4, 4, 4, 4, 4, 4, 4, 4, 4],
        [4, 4, 4, 4, 4, 4, 4, 4, 4, 4, 4, 4, 4, 4, 4, 4],
        [4, 4, 4, 4, 4, 4, 4, 4, 4, 4, 4, 4, 4, 4, 4, 4],
        [4, 4, 4, 4, 4, 4, 4, 4, 4, 4, 4, 4, 4, 4, 4, 4],
        [4, 4, 4, 4, 4, 4, 4, 4, 4, 4, 4, 4, 4, 4, 4, 4],
        [4, 4, 4, 4, 4, 4, 4, 4, 4, 4, 4, 4, 4, 4, 4, 4],
        [4, 4, 4, 4, 4, 4, 4, 4, 4, 4, 4, 4, 4, 4, 4, 4],
        [9, 9, 9, 9, 9, 9, 9, 9, 9, 9, 9, 9, 9, 9, 9, 9],
        [2, 2, 2, 2, 2, 2, 2, 2, 2, 2, 2, 2, 2, 2, 2, 2],
        [2, 2, 2, 2, 2, 2, 2, 2, 2, 2, 2, 2, 2, 2, 2, 2],
        [2, 2, 2, 2, 2, 2, 2, 2, 2, 2, 2, 2, 2, 2, 2, 2]
      ],
      "enemies": [],
      "items": [
        {"type": "sword", "x": 8, "y": 3}
      ],
      "npcs": [],
      "warps": []
    },
    {
      "col": 9,
      "tiles": [
        [4, 4, 4, 4, 4, 4, 4, 4, 4, 4, 4, 1, 1, 1, 1, 1],
        [4, 4, 4, 4, 4, 4, 4, 4, 4, 4, 1, 1, 1, 1, 1, 1],
        [4, 4, 4, 4, 4, 4, 4, 4, 4, 0, 0, 0, 1, 1, 1, 1],
        [4, 4, 4, 4, 4, 4, 4, 17, 0, 0, 0, 0, 0, 1, 1, 1],
        [4, 4, 4, 4, 4, 4, 0, 0, 0, 0, 17, 0, 0, 0, 1, 1],
        [4, 4, 4, 4, 4, 0, 0, 0, 0, 0, 0, 0, 0, 0, 1, 1],
        [4, 4, 4, 4, 0, 0, 0, 0, 0, 0, 0, 0, 17, 0, 1, 1],
        [4, 4, 4, 0, 0, 0, 0, 0, 0, 0, 0, 0, 0, 1, 1, 1],
        [4, 4, 0, 0, 0, 0, 0, 0, 0, 0, 0, 0, 1, 1, 1, 1],
        [4, 0, 0, 0, 0, 0, 0, 0, 0, 0, 0, 1, 1, 1, 1, 1],
        [0, 0, 0, 0, 0, 0, 4, 4, 0, 0, 1, 1, 1, 1, 1, 1],
        [0, 0, 0, 0, 4, 4, 4, 4, 4, 1, 1, 1, 1, 1, 1, 1]
      ],
      "enemies": [
        {"type": 0, "x": 7, "y": 5},
        {"type": 0, "x": 5, "y": 8}
      ],
      "items": [
        {"type": 1, "x": 9, "y": 4}
      ],
      "npcs": [],
      "warps": []
    },
    {
      "col": 10,
      "tiles": [
        [1, 1, 1, 1, 1, 1, 1, 1, 1, 1, 1, 1, 1, 1, 1, 1],
        [1, 1, 1, 1, 1, 1, 1, 1, 1, 1, 1, 1, 1, 1, 1, 1],
        [1, 1, 1, 1, 1, 1, 1, 1, 1, 1, 1, 1, 1, 1, 1, 1],
        [1, 1, 1, 1, 1, 1, 1, 1, 1, 1, 1, 1, 1, 1, 1, 1],
        [1, 1, 1, 1, 1, 0, 0, 1, 1, 1, 1, 1, 1, 1, 1, 1],
        [1, 1, 1, 1, 0, 0, 0, 0, 1, 1, 1, 1, 1, 1, 1, 1],
        [1, 1, 1, 0, 0, 17, 0, 0, 0, 1, 1, 1, 1, 1, 1, 1],
        [1, 1, 1, 1, 0, 0, 0, 1, 1, 1, 1, 1, 1, 1, 1, 1],
        [1, 1, 1, 1, 1, 0, 1, 1, 1, 1, 1, 1, 1, 1, 1, 1],
        [1, 1, 1, 1, 1, 1, 1, 1, 1, 1, 1, 1, 1, 1, 1, 1],
        [1, 1, 1, 1, 1, 1, 1, 1, 1, 1, 1, 1, 1, 1, 1, 1],
        [1, 1, 1, 1, 1, 1, 1, 1, 1, 1, 1, 1, 1, 1, 1, 1]
      ],
      "enemies": [],
      "items": [],
      "npcs": [],
      "warps": []
    }
  ]
}
