{
  "row": 12,
  "screens": [
    {
      "col": 6,
      "tiles": [
        [2, 2, 2, 2, 2, 2, 2, 2, 0, 0, 0, 0, 0, 0, 4, 4],
        [2, 2, 2, 2, 2, 2, 2, 0, 0, 0, 0, 0, 0, 4, 4, 4],
        [2, 2, 2, 2, 2, 2, 0, 0, 0, 0, 0, 0, 4, 4, 4, 4],
        [2, 2, 2, 2, 2, 0, 0, 0, 0, 0, 0, 4, 4, 4, 4, 4],
        [2, 2, 2, 2, 0, 0, 0, 0, 0, 0, 4, 4, 4, 4, 4, 4],
        [2, 2, 2, 0, 0, 0, 0, 0, 0, 4, 4, 4, 4, 4, 4, 4],
        [2, 2, 0, 0, 0, 0, 0, 0, 4, 4, 4, 4, 4, 4, 4, 4],
        [2, 2, 2, 0, 0, 0, 0, 4, 4, 4, 4, 4, 4, 4, 4, 4],
        [2, 2, 2, 2, 0, 0, 4, 4, 4, 4, 4, 4, 4, 4, 4, 4],
        [2, 2, 2, 2, 2, 4, 4, 4, 4, 4, 4, 4, 4, 4, 4, 4],
        [2, 2, 2, 2, 2, 2, 4, 4, 4, 4, 4, 4, 4, 4, 4, 4],
        [2, 2, 2, 2, 2, 2, 2, 2, 2, 2, 2, 2, 2, 2, 2, 2]
      ],
      "enemies": [],
      "items": [],
      "npcs": [],
      "warps": []
    },
    {
      "col": 7,
      "tiles": [
        [4, 4, 0, 0, 0, 0, 0, 4, 4, 4, 0, 0, 0, 0, 0, 0],
        [4, 0, 0, 0, 0, 0, 0, 0, 4, 0, 0, 0, 0, 0, 0, 0],
        [0, 0, 0, 0, 0, 0, 0, 0, 0, 0, 0, 0, 0, 0, 0, 0],
        [0, 0, 0, 0, 0, 0, 0, 0, 0, 0, 0, 0, 0, 0, 0, 0],
        [0, 0, 0, 0, 4, 4, 0, 0, 0, 0, 0, 4, 4, 0, 0, 0],
        [0, 0, 0, 4, 4, 4, 4, 0, 0, 0, 4, 4, 4, 4, 0, 0],
        [9, 9, 9, 9, 9, 9, 9, 9, 9, 9, 9, 9, 9, 9, 9, 9],
        [2, 2, 2, 2, 2, 2, 2, 2, 2, 2, 2, 2, 2, 2, 2, 2],
        [2, 2, 2, 2, 2, 2, 2, 2, 2, 2, 2, 2, 2, 2, 2, 2],
        [2, 2, 2, 2, 2, 2, 2, 2, 2, 2, 2, 2, 2, 2, 2, 2],
        [2, 2, 2, 2, 2, 2, 2, 2, 2, 2, 2, 2, 2, 2, 2, 2],
        [2, 2, 2, 2, 2, 2, 2, 2, 2, 2, 2, 2, 2, 2, 2, 2]
      ],
      "enemies": [],
      "items": [
        {"type": 1, "x": 8, "y": 2}
      ],
      "npcs": [],
      "warps": []
    },
    {
      "col": 8,
      "tiles": [
        [2, 2, 2, 2, 2, 2, 2, 2, 2, 2, 2, 2, 2, 2, 2, 2],
        [2, 2, 2, 2, 2, 2, 2, 2, 2, 2, 2, 2, 2, 2, 2, 2],
        [9, 9, 9, 9, 9, 9, 9, 9, 9, 9, 9, 9, 9, 9, 9, 9],
        [4, 4, 4, 4, 4, 4, 4, 4, 4, 4, 4, 4, 4, 4, 4, 4],
        [4, 4, 4, 4, 4, 4, 4, 4, 4, 4, 4, 4, 4, 4, 4, 4],
        [4, 4, 4, 4, 4, 4, 4, 4, 4, 4, 4, 4, 4, 4, 4, 4],
        [9, 9, 9, 9, 9, 9, 9, 9, 9, 9, 9, 9, 9, 9, 9, 9],
        [2, 2, 2, 2, 2, 2, 2, 2, 2, 2, 2, 2, 2, 2, 2, 2],
        [2, 2, 2, 2, 2, 2, 2, 2, 2, 2, 2, 2, 2, 2, 2, 2],
        [2, 2, 2, 2, 2, 2, 2, 2, 2, 2, 2, 2, 2, 2, 2, 2],
        [2, 2, 2, 2, 2, 2, 2, 2, 2, 2, 2, 2, 2, 2, 2, 2],
        [2, 2, 2, 2, 2, 2, 2, 2, 2, 2, 2, 2, 2, 2, 2, 2]
      ],
      "enemies": [],
      "items": [],
      "npcs": [],
      "warps": []
    },
    {
      "col": 9,
      "tiles": [
        [0, 0, 0, 0, 4, 4, 4, 4, 4, 1, 1, 1, 1, 1, 1, 1],
        [0, 0, 0, 4, 4, 4, 4, 4, 1, 1, 1, 1, 1, 1, 1, 1],
        [0, 0, 4, 4, 4, 4, 4, 1, 1, 1, 1, 1, 1, 1, 1, 1],
        [0, 4, 4, 4, 4, 4, 1, 1, 1, 1, 1, 1, 1, 1, 1, 1],
        [4, 4, 4, 4, 4, 1, 1, 1, 1, 1, 1, 1, 1, 1, 1, 1],
        [9, 9, 9, 9, 9, 9, 1, 1, 1, 1, 1, 1, 1, 1, 1, 1],
        [2, 2, 2, 2, 2, 2, 2, 1, 1, 1, 1, 1, 1, 1, 1, 1],
        [2, 2, 2, 2, 2, 2, 2, 2, 1, 1, 1, 1, 1, 1, 1, 1],
        [2, 2, 2, 2, 2, 2, 2, 2, 2, 1, 1, 1, 1, 1, 1, 1],
        [2, 2, 2, 2, 2, 2, 2, 2, 2, 2, 1, 1, 1, 1, 1, 1],
        [2, 2, 2, 2, 2, 2, 2, 2, 2, 2, 2, 1, 1, 1, 1, 1],
        [2, 2, 2, 2, 2, 2, 2, 2, 2, 2, 2, 2, 1, 1, 1, 1]
      ],
      "enemies": [],
      "items": [],
      "npcs": [],
      "warps": []
    }
  ]
}
