{
  "row": 9,
  "screens": [
    {
      "col": 6,
      "tiles": [
        [1, 1, 1, 0, 0, 0, 0, 0, 0, 0, 0, 0, 0, 0, 0, 0],
        [1, 0, 0, 0, 0, 16, 0, 0, 0, 0, 16, 0, 0, 0, 0, 0],
        [1, 0, 0, 40, 0, 0, 0, 0, 0, 0, 0, 0, 40, 0, 0, 0],
        [1, 0, 0, 0, 0, 0, 0, 0, 0, 0, 0, 0, 0, 0, 0, 0],
        [1, 0, 16, 0, 0, 0, 0, 17, 0, 0, 0, 0, 16, 0, 0, 0],
        [1, 0, 0, 0, 0, 0, 0, 0, 0, 0, 0, 0, 0, 0, 0, 0],
        [1, 0, 0, 0, 0, 16, 0, 0, 0, 0, 16, 0, 0, 0, 0, 0],
        [1, 0, 40, 0, 0, 0, 0, 0, 0, 0, 0, 0, 0, 40, 0, 0],
        [1, 0, 0, 0, 0, 0, 0, 0, 0, 0, 0, 0, 0, 0, 0, 0],
        [1, 0, 0, 16, 0, 0, 0, 0, 0, 0, 0, 0, 16, 0, 0, 0],
        [1, 0, 0, 0, 0, 0, 0, 0, 0, 0, 0, 0, 0, 0, 0, 0],
        [1, 1, 0, 0, 0, 0, 0, 0, 0, 0, 0, 0, 0, 0, 0, 0]
      ],
      "enemies": [],
      "items": [
        {"type": 1, "x": 8, "y": 5}
      ],
      "npcs": [],
      "warps": []
    },
    {
      "col": 7,
      "tiles": [
        [1, 0, 0, 0, 0, 0, 4, 4, 0, 0, 0, 0, 0, 0, 0, 0],
        [1, 0, 0, 2, 2, 0, 0, 0, 0, 0, 0, 2, 2, 0, 0, 0],
        [1, 0, 2, 2, 2, 2, 0, 0, 2, 0, 2, 2, 2, 2, 0, 0],
        [1, 0, 0, 2, 2, 0, 0, 2, 2, 2, 0, 2, 2, 0, 0, 0],
        [1, 0, 0, 0, 0, 0, 0, 2, 2, 2, 0, 0, 0, 0, 0, 0],
        [1, 0, 0, 2, 0, 0, 0, 0, 0, 0, 0, 0, 2, 0, 0, 0],
        [1, 0, 2, 2, 2, 0, 0, 2, 2, 0, 0, 2, 2, 2, 0, 0],
        [1, 0, 0, 2, 0, 0, 2, 2, 2, 2, 0, 0, 2, 0, 0, 0],
        [1, 0, 0, 0, 0, 0, 0, 2, 2, 0, 0, 0, 0, 0, 0, 0],
        [1, 0, 0, 2, 2, 0, 0, 0, 0, 0, 0, 2, 2, 0, 0, 0],
        [1, 0, 0, 0, 0, 0, 0, 0, 0, 0, 0, 0, 0, 0, 0, 0],
        [1, 0, 0, 0, 0, 0, 0, 0, 0, 0, 0, 0, 0, 0, 0, 0]
      ],
      "enemies": [
        {"type": 2, "x": 5, "y": 5},
        {"type": 2, "x": 11, "y": 9}
      ],
      "items": [],
      "npcs": [],
      "warps": []
    },
    {
      "col": 8,
      "tiles": [
        [0, 0, 0, 0, 0, 0, 0, 0, 0, 0, 0, 0, 0, 0, 0, 0],
        [0, 44, 44, 44, 44, 0, 0, 0, 0, 0, 0, 0, 0, 0, 0, 0],
        [0, 43, 43, 43, 43, 0, 0, 0, 0, 0, 0, 0, 0, 0, 0, 0],
        [0, 1, 8, 8, 1, 0, 0, 0, 0, 0, 0, 0, 0, 0, 0, 0],
        [0, 0, 0, 0, 0, 0, 46, 46, 46, 46, 0, 0, 0, 0, 0, 0],
        [0, 0, 0, 0, 0, 0, 0, 0, 0, 0, 0, 0, 0, 0, 0, 0],
        [0, 0, 0, 0, 0, 41, 41, 41, 41, 41, 41, 0, 0, 0, 0, 0],
        [0, 0, 0, 0, 0, 0, 0, 0, 0, 0, 0, 0, 0, 0, 0, 0],
        [0, 0, 16, 0, 0, 0, 0, 0, 0, 0, 0, 0, 16, 0, 0, 0],
        [0, 0, 0, 0, 0, 0, 0, 0, 0, 0, 0, 0, 0, 0, 0, 0],
        [0, 0, 0, 0, 0, 41, 41, 41, 41, 41, 41, 0, 0, 0, 0, 0],
        [0, 0, 0, 0, 0, 0, 0, 0, 0, 0, 0, 0, 0, 0, 0, 0]
      ],
      "enemies": [],
      "items": [],
      "npcs": [],
      "warps": [
        {"x": 2, "y": 3, "target": "interior:meowmeow_house", "sx": 112, "sy": 144, "ex": 33, "ey": 66},
        {"x": 3, "y": 3, "target": "interior:meowmeow_house", "sx": 112, "sy": 144, "ex": 49, "ey": 66}
      ]
    },
    {
      "col": 9,
      "tiles": [
        [0, 0, 0, 0, 0, 0, 0, 0, 0, 0, 0, 0, 0, 0, 0, 1],
        [0, 0, 1, 1, 1, 1, 0, 0, 0, 1, 1, 1, 1, 0, 0, 1],
        [0, 0, 1, 5, 5, 1, 0, 0, 0, 1, 5, 5, 1, 0, 0, 1],
        [0, 0, 1, 5, 5, 1, 0, 0, 0, 1, 5, 5, 1, 0, 0, 1],
        [0, 0, 1, 0, 0, 1, 0, 0, 0, 1, 0, 0, 1, 0, 0, 1],
        [0, 0, 0, 0, 0, 0, 0, 0, 0, 0, 0, 0, 0, 0, 0, 1],
        [0, 0, 5, 5, 5, 0, 0, 6, 0, 0, 5, 5, 5, 0, 0, 1],
        [0, 0, 5, 5, 5, 0, 0, 0, 0, 0, 5, 5, 5, 0, 0, 1],
        [0, 0, 0, 0, 0, 0, 0, 0, 0, 0, 0, 0, 0, 0, 0, 1],
        [0, 0, 1, 1, 0, 0, 1, 1, 1, 0, 0, 1, 1, 0, 0, 1],
        [0, 0, 1, 1, 0, 0, 1, 5, 1, 0, 0, 1, 1, 0, 0, 1],
        [1, 1, 1, 1, 1, 1, 1, 1, 1, 1, 1, 1, 1, 1, 1, 1]
      ],
      "enemies": [
        {"type": 2, "x": 5, "y": 5},
        {"type": 2, "x": 10, "y": 5},
        {"type": 1, "x": 8, "y": 8}
      ],
      "items": [
        {"type": 2, "x": 4, "y": 7},
        {"type": 1, "x": 11, "y": 7},
        {"type": 1, "x": 12, "y": 6}
      ],
      "npcs": [
        {"x": 8, "y": 6, "dir": 0, "name": "Ghost", "dialogue_key": "ghost_ruins"}
      ],
      "warps": [
        {"x": 7, "y": 6, "target": "interior:ruins_dungeon", "sx": 112, "sy": 128, "ex": 113, "ey": 98}
      ]
    },
    {
      "col": 10,
      "tiles": [
        [0, 0, 0, 0, 0, 0, 0, 0, 0, 0, 0, 0, 0, 0, 1, 1],
        [0, 0, 0, 0, 0, 0, 0, 40, 0, 0, 0, 0, 0, 0, 1, 1],
        [0, 0, 16, 0, 0, 0, 0, 0, 0, 0, 16, 0, 0, 1, 1, 1],
        [0, 0, 0, 0, 0, 0, 0, 0, 0, 0, 0, 0, 0, 0, 1, 1],
        [0, 0, 0, 0, 16, 0, 0, 0, 0, 16, 0, 0, 0, 0, 1, 1],
        [0, 0, 0, 0, 0, 0, 0, 0, 0, 0, 0, 0, 0, 1, 1, 1],
        [0, 0, 0, 0, 0, 0, 40, 0, 0, 0, 0, 0, 0, 0, 1, 1],
        [0, 0, 16, 0, 0, 0, 0, 0, 0, 0, 16, 0, 0, 0, 1, 1],
        [0, 0, 0, 0, 0, 0, 0, 0, 0, 0, 0, 0, 0, 1, 1, 1],
        [0, 0, 0, 0, 0, 0, 0, 0, 0, 0, 0, 0, 0, 1, 1, 1],
        [0, 0, 0, 0, 0, 0, 0, 0, 0, 0, 0, 0, 1, 1, 1, 1],
        [1, 1, 0, 0, 0, 0, 0, 0, 0, 0, 0, 1, 1, 1, 1, 1]
      ],
      "enemies": [
        {"type": 0, "x": 5, "y": 4},
        {"type": 0, "x": 9, "y": 7}
      ],
      "items": [],
      "npcs": [],
      "warps": []
    }
  ]
}
