{
  "interiors": [
    {
      "id": "tarins_house",
      "tiles": [
        [1,1,1,1,1,1,1,1,1,1,1,1,1,1,1,1],
        [1,1,1,1,1,1,1,1,1,1,1,1,1,1,1,1],
        [1,1,1,1,1,1,1,1,1,1,1,1,1,1,1,1],
        [1,1,1,1,5,5,5,5,5,5,5,5,1,1,1,1],
        [1,1,1,1,5,5,5,5,5,5,5,5,1,1,1,1],
        [1,1,1,1,5,5,5,5,5,5,5,5,1,1,1,1],
        [1,1,1,1,5,5,5,5,5,5,5,5,1,1,1,1],
        [1,1,1,1,5,5,5,5,5,5,5,5,1,1,1,1],
        [1,1,1,1,5,5,5,5,5,5,5,5,1,1,1,1],
        [1,1,1,1,5,5,5,5,5,5,5,5,1,1,1,1],
        [1,1,1,1,1,1,5,8,5,1,1,1,1,1,1,1],
        [1,1,1,1,1,1,1,1,1,1,1,1,1,1,1,1]
      ],
      "enemies": [],
      "items": [],
      "npcs": [
        {
          "id": "tarin", "x": 8, "y": 5, "dir": 0, "name": "Tarin",
          "dialogue_key": "tarin_intro",
          "dialogues": [
            {"key": "tarin_has_sword", "condition": "item:sword"},
            {"key": "tarin_intro", "condition": ""}
          ]
        }
      ],
      "warps": [
        {"x": 7, "y": 10, "target": "overworld", "sx": 0, "sy": 0, "ex": 33, "ey": 66}
      ]
    },
    {
      "id": "library",
      "tiles": [
        [1,1,1,1,1,1,1,1,1,1,1,1,1,1,1,1],
        [1,1,1,1,1,1,1,1,1,1,1,1,1,1,1,1],
        [1,1,1,1,1,1,1,1,1,1,1,1,1,1,1,1],
        [1,1,1,1,1,1,1,1,1,1,1,1,1,1,1,1],
        [1,1,1,1,1,5,5,5,5,5,5,1,1,1,1,1],
        [1,1,1,1,1,5,5,5,5,5,5,1,1,1,1,1],
        [1,1,1,1,1,5,5,5,5,5,5,1,1,1,1,1],
        [1,1,1,1,1,5,5,5,5,5,5,1,1,1,1,1],
        [1,1,1,1,1,5,5,5,5,5,5,1,1,1,1,1],
        [1,1,1,1,1,5,5,5,5,5,5,1,1,1,1,1],
        [1,1,1,1,1,1,5,8,5,1,1,1,1,1,1,1],
        [1,1,1,1,1,1,1,1,1,1,1,1,1,1,1,1]
      ],
      "enemies": [],
      "items": [],
      "npcs": [
        {
          "id": "librarian", "x": 7, "y": 5, "dir": 0, "name": "Librarian",
          "dialogue_key": "librarian_lore"
        }
      ],
      "warps": [
        {"x": 7, "y": 10, "target": "overworld", "sx": 0, "sy": 0, "ex": 33, "ey": 66}
      ]
    },
    {
      "id": "village_shop",
      "tiles": [
        [1,1,1,1,1,1,1,1,1,1,1,1,1,1,1,1],
        [1,1,1,1,1,1,1,1,1,1,1,1,1,1,1,1],
        [1,1,1,1,1,1,1,1,1,1,1,1,1,1,1,1],
        [1,1,1,1,1,1,1,1,1,1,1,1,1,1,1,1],
        [1,1,1,1,1,5,5,5,5,5,5,1,1,1,1,1],
        [1,1,1,1,1,5,5,5,5,5,5,1,1,1,1,1],
        [1,1,1,1,1,5,5,5,5,5,5,1,1,1,1,1],
        [1,1,1,1,1,5,5,5,5,5,5,1,1,1,1,1],
        [1,1,1,1,1,5,5,5,5,5,5,1,1,1,1,1],
        [1,1,1,1,1,5,5,5,5,5,5,1,1,1,1,1],
        [1,1,1,1,1,1,5,8,5,1,1,1,1,1,1,1],
        [1,1,1,1,1,1,1,1,1,1,1,1,1,1,1,1]
      ],
      "enemies": [],
      "items": [],
      "npcs": [
        {
          "id": "shopkeeper", "x": 8, "y": 5, "dir": 0, "name": "Shopkeeper",
          "dialogue_key": "shopkeeper_hello"
        }
      ],
      "warps": [
        {"x": 7, "y": 10, "target": "overworld", "sx": 0, "sy": 0, "ex": 193, "ey": 66}
      ]
    },
    {
      "id": "meowmeow_house",
      "tiles": [
        [1,1,1,1,1,1,1,1,1,1,1,1,1,1,1,1],
        [1,1,1,1,1,1,1,1,1,1,1,1,1,1,1,1],
        [1,1,1,1,1,1,1,1,1,1,1,1,1,1,1,1],
        [1,1,1,1,1,1,1,1,1,1,1,1,1,1,1,1],
        [1,1,1,1,5,5,5,5,5,5,5,5,1,1,1,1],
        [1,1,1,1,5,5,5,5,5,5,5,5,1,1,1,1],
        [1,1,1,1,5,5,5,5,5,5,5,5,1,1,1,1],
        [1,1,1,1,5,5,5,5,5,5,5,5,1,1,1,1],
        [1,1,1,1,5,5,5,5,5,5,5,5,1,1,1,1],
        [1,1,1,1,5,5,5,5,5,5,5,5,1,1,1,1],
        [1,1,1,1,1,1,5,8,5,1,1,1,1,1,1,1],
        [1,1,1,1,1,1,1,1,1,1,1,1,1,1,1,1]
      ],
      "enemies": [],
      "items": [],
      "npcs": [
        {
          "id": "meowmeow", "x": 8, "y": 6, "dir": 0, "name": "Madam MeowMeow",
          "dialogue_key": "meowmeow_intro"
        }
      ],
      "warps": [
        {"x": 7, "y": 10, "target": "overworld", "sx": 0, "sy": 0, "ex": 33, "ey": 66}
      ]
    },
    {
      "id": "phone_booth",
      "tiles": [
        [1,1,1,1,1,1,1,1,1,1,1,1,1,1,1,1],
        [1,1,1,1,1,1,1,1,1,1,1,1,1,1,1,1],
        [1,1,1,1,1,1,1,1,1,1,1,1,1,1,1,1],
        [1,1,1,1,1,1,1,1,1,1,1,1,1,1,1,1],
        [1,1,1,1,1,1,1,1,1,1,1,1,1,1,1,1],
        [1,1,1,1,1,1,1,1,1,1,1,1,1,1,1,1],
        [1,1,1,1,1,1,5,20,5,1,1,1,1,1,1,1],
        [1,1,1,1,1,1,5,5,5,1,1,1,1,1,1,1],
        [1,1,1,1,1,1,5,5,5,1,1,1,1,1,1,1],
        [1,1,1,1,1,1,5,5,5,1,1,1,1,1,1,1],
        [1,1,1,1,1,1,5,8,5,1,1,1,1,1,1,1],
        [1,1,1,1,1,1,1,1,1,1,1,1,1,1,1,1]
      ],
      "enemies": [],
      "items": [],
      "npcs": [],
      "warps": [
        {"x": 7, "y": 10, "target": "overworld", "sx": 0, "sy": 0, "ex": 113, "ey": 113}
      ]
    },
    {
      "id": "old_mans_cave",
      "tiles": [
        [1,1,1,1,1,1,1,1,1,1,1,1,1,1,1,1],
        [1,1,1,1,1,1,1,1,1,1,1,1,1,1,1,1],
        [1,1,1,1,1,1,1,1,1,1,1,1,1,1,1,1],
        [1,1,1,1,5,5,5,5,5,5,5,5,1,1,1,1],
        [1,1,1,1,5,5,5,5,5,5,5,5,1,1,1,1],
        [1,1,1,1,5,5,5,5,5,5,5,5,1,1,1,1],
        [1,1,1,1,5,5,5,5,5,5,5,5,1,1,1,1],
        [1,1,1,1,5,5,5,5,5,5,5,5,1,1,1,1],
        [1,1,1,1,5,5,5,5,5,5,5,5,1,1,1,1],
        [1,1,1,1,1,1,1,1,1,1,1,1,1,1,1,1],
        [1,1,1,1,1,1,1,8,5,1,1,1,1,1,1,1],
        [1,1,1,1,1,1,1,1,1,1,1,1,1,1,1,1]
      ],
      "enemies": [],
      "items": [],
      "npcs": [
        {
          "id": "old_man", "x": 8, "y": 5, "dir": 0, "name": "Old Man",
          "dialogue_key": "old_man_cave"
        }
      ],
      "warps": [
        {"x": 7, "y": 10, "target": "overworld", "sx": 0, "sy": 0, "ex": 113, "ey": 113}
      ]
    }
  ]
}
