{
  "interiors": [
    {
      "id": "forest_cave",
      "tiles": [
        [1,1,1,1,1,1,1,1,1,1,1,1,1,1,1,1],
        [1,1,1,1,1,1,1,1,1,1,1,1,1,1,1,1],
        [1,1,1,1,1,1,1,1,1,1,1,1,1,1,1,1],
        [1,1,1,1,5,5,5,5,5,5,5,5,5,5,1,1],
        [1,1,1,1,5,5,5,5,5,5,5,5,5,5,1,1],
        [1,1,1,1,5,5,5,5,5,5,5,5,5,5,1,1],
        [1,1,1,1,5,5,5,5,5,5,5,5,5,5,1,1],
        [1,1,1,1,5,5,5,5,5,5,5,5,5,5,1,1],
        [1,1,1,1,5,5,5,5,5,5,5,5,5,5,1,1],
        [1,1,1,1,1,1,1,1,1,1,1,1,1,1,1,1],
        [1,1,1,1,1,1,1,8,5,1,1,1,1,1,1,1],
        [1,1,1,1,1,1,1,1,1,1,1,1,1,1,1,1]
      ],
      "enemies": [
        {"type": "octorok", "x": 7, "y": 4},
        {"type": "octorok", "x": 10, "y": 6}
      ],
      "items": [
        {"type": "rupee", "x": 6, "y": 5}
      ],
      "npcs": [],
      "warps": [
        {"x": 7, "y": 10, "target": "overworld", "sx": 0, "sy": 0, "ex": 0, "ey": 0}
      ]
    },
    {
      "id": "ruins_dungeon",
      "tiles": [
        [1,1,1,1,1,1,1,1,1,1,1,1,1,1,1,1],
        [1,1,1,1,1,1,1,1,1,1,1,1,1,1,1,1],
        [1,1,1,5,5,5,5,5,5,5,5,5,5,5,5,1],
        [1,1,1,5,5,5,5,5,6,5,5,5,5,5,5,1],
        [1,1,1,5,5,5,5,5,5,5,5,5,5,5,5,1],
        [1,1,1,5,5,5,5,5,5,5,5,5,5,5,5,1],
        [1,1,1,5,5,5,5,5,5,5,5,5,5,5,5,1],
        [1,1,1,5,5,5,5,5,5,5,5,5,5,5,5,1],
        [1,1,1,5,5,5,5,5,5,5,5,5,5,5,5,1],
        [1,1,1,5,5,5,5,5,5,5,5,5,5,5,5,1],
        [1,1,1,1,1,1,1,8,5,1,1,1,1,1,1,1],
        [1,1,1,1,1,1,1,1,1,1,1,1,1,1,1,1]
      ],
      "enemies": [
        {"type": "stalfos", "x": 6, "y": 4},
        {"type": "stalfos", "x": 11, "y": 7}
      ],
      "items": [
        {"type": "rupee", "x": 9, "y": 5},
        {"type": "rupee", "x": 10, "y": 5},
        {"type": "heart_container", "x": 9, "y": 4}
      ],
      "npcs": [],
      "warps": [
        {"x": 8, "y": 3, "target": "interior:boss_room", "sx": 112, "sy": 144, "ex": 128, "ey": 64},
        {"x": 7, "y": 10, "target": "overworld", "sx": 0, "sy": 0, "ex": 0, "ey": 0}
      ]
    },
    {
      "id": "boss_room",
      "tiles": [
        [1,1,1,1,1,1,1,1,1,1,1,1,1,1,1,1],
        [1,1,1,1,1,1,1,1,1,1,1,1,1,1,1,1],
        [1,1,5,5,5,5,5,5,5,5,5,5,5,5,1,1],
        [1,1,5,5,5,5,5,5,5,5,5,5,5,5,1,1],
        [1,1,5,5,5,1,5,5,5,5,1,5,5,5,1,1],
        [1,1,5,5,5,5,5,5,5,5,5,5,5,5,1,1],
        [1,1,5,5,5,5,5,5,5,5,5,5,5,5,1,1],
        [1,1,5,5,5,1,5,5,5,5,1,5,5,5,1,1],
        [1,1,5,5,5,5,5,5,5,5,5,5,5,5,1,1],
        [1,1,5,5,5,5,5,5,5,5,5,5,5,5,1,1],
        [1,1,1,1,1,1,1,8,1,1,1,1,1,1,1,1],
        [1,1,1,1,1,1,1,1,1,1,1,1,1,1,1,1]
      ],
      "enemies": [
        {"type": "boss", "x": 7, "y": 3}
      ],
      "items": [],
      "npcs": [],
      "warps": [
        {"x": 7, "y": 10, "target": "interior:ruins_dungeon", "sx": 128, "sy": 48, "ex": 128, "ey": 64}
      ]
    }
  ]
}
